XXXXXXXXXXXXXXXXXXXXXXXXXXXXXXXXXXXXXXXXXXXXXXXXXXXXXXXXXXXXXXXXXXXXXXXXXXXXXXXXXXXXXXXXXXXXXXXXXXXXXXXXXXXXXXXXX
X----------------------------------------------------------------------------------T----------------------------X
X----------------------------------------------------------------------------------T----------------------------X
X----------------------------------------------------------------------------------T----------------------------X
X-----------------------------------------------------------------------------------------------------T---------X
X----------------------------------------------------------------------------------------------------TTT--------X
X--------------------------------------------------XXXXXXXXXXXXXXXXXXXX-----------------------------TTTTT-------X
X--------------------------------------------------------------------------------------------------TTTTTTT------X
X--P----------------------------------------------------------------------------------------------TTTTTTTTT-----X
X-----------------------T------------------------------------------------------------------------TTTTTTTTTTT----X
X--------------------------------------T-----------TTTTTTTTTTTTTTTTTTTT------------T------------TTTTTTTTTTTTT--GX
XXXXXXXXXXXXXXXXXXXXXXXXXXXXXXXXXXXXXXXXXXXXXXXXXXXXXXXXXXXXXXXXXXXXXXXXXXXXXXXXXXXXXXXXXXXXXXXXXXXXXXXXXXXXXXXXX
