XXXXXXXXXXXXXXXXXXXXXXXXXXXXXXXXXXXXXXXXXXXXXXXXXX
X----------------------------------------------XGX
X----------------------------------------------X-X
X----------------------------------------------X-X
X----------------------------------------------X-X
X----------------------------------------------X-X
X--P---------------------------------------------X
X----------------------------------------------H-X
X------------------------------------------------X
XXXXXXXXXXXXXXXXXXXXXXXXXXXXXXXXXXXXXXXXXXXXXXXXXX
